2 17 15
#################
#p**#f  1*    *b#
#b#*###*# #***#*#
#   #  ***     2#
# **# # #k#*#*#*#
#   *    *    *s#
# # # # # # # # #
#   1  * * 2    #
# # # # #*#*# # #
#   **    *    2#
#*#*# # # #*# #*#
#  *         **#
# # # # #***#*###
#2   *  *     1#
#################