1 15 17
t###############t
#p 2*** * # 1 **#
# *#  * #   #   #
#*  1 *   #*****#
#*#* #  ** *    #
#* *#    ***    #
#  1  ***       #
#**#**  ***     #
# *    th       #
#  *   h * #*#**#
# *1     *  1   #
#  ######*   2  #
# *   *  * # #* #
#1    *  2   # f#
t###############t