1 15 17
#################
#p     s*       #
#    cc *  cc   #
#       ****    #
#*  #       c   #
#*          c   #
#* c        c   #
#* c         #  #
#* c            #
#*    #         #
#*       B      #
#               #
######*#*******##
#  f f k b b h 1#
#################